1111111
1000001
1PCCCE1
1111111