111111111111111111111111111111111111111111
1P0000000000000000000000000000000000000001
1111111111111111111111111111111111111111C1
1CCCCCCCCCCCCCCCCCCCCCCCCCCCCCCCCCCCCCCCC1
1C0000000000000000000000000000000000000001
1E1111111111111111111111111111111111111111
111111111111111111111111111111111111111111