111111
1P0C01
101111
1C0E11
111111