1111111
1P000E1
1C101C1
1000001
1010101
1C00001
1111111