1111111
1P00001
1010101
1C0C0E1
1010101
1C0C0C1
1111111