111111111111111
1P00000000000E1
101011101110101
1C000C000C000C1
100001110110001
1C00100001000C1
101110111011101
1C000C000C000C1
111111111111111