111111
1P0001
1C1011
100001
1E0011
111111