111111111
1P0000E01
101110001
1C000C001
101110001
1C000C001
100000001
111111111