11111111111111111
1000000000000E111
10101110111010111
1C000C000C000C111
10000111011000111
1C00100001000C111
10111011101110111
1C000C000C000C111
1P00000000000C111
11111111111111111