11111111111
1E0CCCCCCP1
10000000001
10000000001
10000000001
10000000001
10000000001
10000000001
11111111111