111111111111111
1P000E0000000C1
111111111111111